led (lead의 과거) : 지도되는, 이끌다.
attend : 참석하다.
conference : 회의
discuss : 상의하다, 논하다, 논의하다.
conclude : 결론을 내리다.
conclusion : 결론, 결말
economic : 경제의, 경제성이 있는
stable : 안정된, 마구간, 넣다.
stability : 안정, 안정성

- 형용사처럼 보이지만 품사가 명사인 단어들을 주의해야 한다.
applicant(명) : 지원자
delivery(명) : 배달
denial(명) : 부인, 부정
proposal(명) : 제안
complaint(명) : 불만
arrival(명) : 도착
disposal(명) : 처리, 처분
withdrawal(명) : 인출
referral(명) : 추천, 소개

- 동사나 형용사로 많이 사용되지만 명사로도 사용되는 단어들을 주의해야 한다.
prospect(명) : 전망, (동) : 조사하다.
respect (명) : 존경, (동) : 존경하다.
request (명) : 요청, (동) : 요청하다.
review (명) : 검토, (동) : 검토하다.
charge (명) : 요금, (동) : 청구하다.
effect (명) : 영향, 효과, (동) : 초래하다.
objective (명) : 목적, (형) : 객관적인
respondent (명) : 응답자, (형) : 응하는
alternative (명) : 대안, (형) : 대안의
representative (명) : 대표자, (형) : 대표하는, 대리의
potential (명) : 가능성, (형) : 잠재하는

revenue : 수익, 수입
outlook : 관점, 세계관, 인생관, 전망
notity (동) : 통지하다, 통보하다.
tenant (명) : 세입자, 주민
postpone (동) : 연기하다, 뒤로 미루다.
renovate (동) : 수리하다.
archeological (형) : 자아내다, 발생시키다.
relic (명) : 유물, 유적
finding (명) : (조사, 연구) 결과, 결론
accommodate (동) : 수용하다.
commercial (형) : 영리적인, 상업상의
enterprise (명) : 기업, 회사
structural (형) : 구조상의, 조직상의
structure (동) : 구성하다, 조직화하다, (명) : 건물, 구조
expect (동) : 예상하다.
promote (동) : 촉진하다, 홍보하다, 승진시키다.
upcoming (형) : 다가오는, 곧 있을
confirm (동) : 사실임을 보여주다.
reserve (동) : 예약하다.
organize (동) : 준비하다.












